
						                        		      
I     IIIIIIIIIIIIIIIIIIIIIIIIIIIIIIIIIIIIIIIIIIIIIIIIIIIIIIIIIIIIIIIIIIIIIIIIIIIIIIIIIIII
I                                       II                                               I
I                               oooo         oooo                                        I
I                               IIII         IIII                                        I
I                        oooo          oo2o        oooo              oooo                I
I                 ooo 2  IIII    2     IIII     2  IIII   oooo 2     IIII      2         I
I           2     III      2             2         2      IIII      1      2    2        I
I           II                      II     II                      II           II       I
I     1     II     1    1     1     II  1  II   1  2   1        1     1       1      * ! I
IIIIIIIIIIIIIIIIIIIIIIIIIIIIIIIIIIIIIIIIIIIIIIIIIIIIIIIIIIIIIIIIIIIIIIIIIIIIIIIIIIIIIIIIII